1111111111111
1CC00000000C1
11100C1111001
1000C1E000001
1P00110000001
1111111111111