1111111111111
1C010000000C1
1000011110001
1P0011E0001C1
1111111111111