1111111111111
10011100000C1
1000000100001
1P0011E100001
1111111111111