1111111111111
1CX10000000C1
10000111110C1
1P00E1XC000X1
1111111111111