1111111111111111111111111111111111
1E000X0000000X0C00000C0000000X0001
1010010100100000101001000000010101
1010010X10101010001001000000010101
1P0000000C00C0000000000000000000C1
1111111111111111111111111111111111