1111111111111
1C010000000C1
1001E011110C1
1P0000CCCCCC1
1111111111111