1111111111111111111111111111111111
1E000000000X000C00000C00000XX00001
101001100100X001010010000000101011
1010010010101010001001000000010101
1P000X000C00C000000X000000X00000C1
1111111111111111111111111111111111