1111111111111
1XX10000000C1
1000001110111
1000001000001
1ECC101P000C1
1111111111111