111111111111
1XE000000001
100000000001
100001CP0001
1X0011000011
111111111111