111111111111
1XE000000001
1X0001110111
1X0001CP0001
1XX001100001
111111111111